自动开始: 刷新页面后是否倒计时10秒后自动启动
自动打boss: 是否去地图自动打boss, 地图可以在挂机地图输入框设置, 填写地图名称, 多个地图用|隔开, 可以添加无数个, 如果不添加则默认使用巡航设置的地图
自动复活: 死亡后自动复活并且开启自动战斗(主要用于跨服阵营战)
自动熔炼: 根据熔炼设置的条件自动熔炼, 如果是其他职业绑定的装备也会自动熔炼
元神升级: 自动升级元神
自动转生: 自动转生
传了个世: 自动领取传了个世奖励
自动领取日常: 自动领取日常奖励和跨服日常奖励(活跃度需要自己去做)
免费10元礼包: 自动领取充值界面中免费领取的10元礼包
自动穿装备: 自动穿戴可以穿的装备
自动使用: 可以自动使用经验和金币(如果赞助了30可以不开启此项)
坐骑升级: 自动升级坐骑
内容任务: 自动完成内功任务, 地图为设置中上古禁地BOSS地图
古宝升级: 自动激活和升级古宝
神炉升级: 自动升级神炉
抢红包: 自动抢红包(可能有bug)
龙魂BOSS: 自动去打解锁的龙魂BOSS
强化精炼: 自动强化精炼
军装升级: 自动升级军装
登录奖励: 自动领取每日登录奖励(活动大厅-开服-登录奖励)
天天赞数: 自动领取天天赞数(活动大厅-活动-天天赞助)
每日直购: 自动领取每日直购免费奖励(活动大厅-活动-每日直购)
在线奖励: 自动领取在线奖励(活动大厅-活动-在线奖励)
三国任务: 自动完成三国任务(打一个三国boss后并领取), 地图为设置的烽火三国地图
行会祈福: 自动进行行会祈福, 免费,金币,钻石,至尊分别对应1,2,3,4, 用竖线隔开, 如果设置了至尊祈福, 会祈福十次
行会商城购买: 自动购买行会商城物品名称, 用竖线隔开
BOSS提前蹲时间: 上古禁地boss和三国boss会在复活之前去蹲一段时间, 单位为秒
每日限购物品: 自动购买商城中每日限购物品, 名称用竖线隔开
挂机地图: 设置挂机地图, 多个地图用|隔开, 可以添加无数个
物品放仓库: 自动放入仓库的物品, 名称用竖线隔开

虚空裂痕: 每日19.30自动进入虚空裂痕
跨服阵营战: 每日20.00会自动进入跨服阵营战(除了周六周日)
跨服神尊BOSS: 每天11,16,21点自动去打跨服boss
跨服神尊BOSS血量: 暂时填写50
异界入侵: 每天20.30自动进入异界入侵地图, 地图范围为1-6
沙巴克: 周六20.00自动进入沙巴克地图
押镖: 每天自动押镖
3v3: 每天自动进行大世界竞技(完事后需要刷新一次, 要不然有bug)

修罗天界层数: 设置需要打的层数, 用竖线隔开, 如果可以扫荡则会自动扫荡
福利BOSS: 体力刷新后自动去打福利BOSS
暗之神殿: 体力刷新后自动去打暗之神殿
武道会: 体力刷新后自动去匹配武道会
神魔BOSS: 每天自动去打神魔BOSS(boss随机)
战骑祭坛: 体力刷新后自动去打战骑祭坛
站起祭坛地图: 数字表示第几个地图, 例如1表示第一个地图, 如果为负数表示倒数第几个, 例如-1表示最后一个地图
跨服遗迹: 体力刷新后自动去打跨服遗迹
跨服魔甲虫: 自动去打30个跨服魔甲虫
魂环秘境: 体力刷新后会自动去打魂环秘境(有限打等级高的)
历练任务: 自动完成历练任务
烽火三国: 自动打烽火三国BOSS(包括分身), 地图可以设置多个, 用|隔开
三国小怪每日信物: 自动打三国小怪获取每天20个信物, 地图可以设置多个, 用|隔开
三国小怪: 自动去打三国小怪, 不会自动停止, 地图可以设置多个, 用|隔开
飞升BOSS: 自动去打飞升BOSS, 地图可以设置多个, 用|隔开
上古禁地BOSS: 自动去打上古禁地BOSS
上古禁地小怪: 自动去打上古禁地小怪
锁魂塔: 自动去打锁魂塔和采集